<HEADER>
frames 12
width 54
height 5
color red
slowdown 15
transparency #
</HEADER>
<BODY>
###______#############################################
##/ ____/#############################################
#/ /#__###############################################
/ /_/ /###############################################
\____/################################################
end
###______#############################################
##/ ____/___#_########################################
#/ /#__/ __ `/########################################
/ /_/ / /_/ /#########################################
\____/\__,_/##########################################
end
###______#############################################
##/ ____/___#_____#___################################
#/ /#__/ __ `/ __ `__ \###############################
/ /_/ / /_/ / /#/ /#/ /###############################
\____/\__,_/_/#/_/#/_/################################
end
###______#############################################
##/ ____/___#_____#___##___###########################
#/ /#__/ __ `/ __ `__ \/ _ \##########################
/ /_/ / /_/ / /#/ /#/ /  __/##########################
\____/\__,_/_/#/_/#/_/\___/###########################
end
###______#############################################
##/ ____/___#_____#___##___###########################
#/ /#__/ __ `/ __ `__ \/ _ \##########################
/ /_/ / /_/ / /#/ /#/ /  __/##########################
\____/\__,_/_/#/_/#/_/\___/###########################
end
###______########################____#################
##/ ____/___#_____#___##___#####/ __ \################
#/ /#__/ __ `/ __ `__ \/ _ \###/ /#/ /################
/ /_/ / /_/ / /#/ /#/ /  __/##/ /_/ /#################
\____/\__,_/_/#/_/#/_/\___/###\____/##################
end
###______########################____#################
##/ ____/___#_____#___##___#####/ __ \_###__##########
#/ /#__/ __ `/ __ `__ \/ _ \###/ /#/ / |#/ /##########
/ /_/ / /_/ / /#/ /#/ /  __/##/ /_/ /| |/ /###########
\____/\__,_/_/#/_/#/_/\___/###\____/#|___/############
end
###______########################____#################
##/ ____/___#_____#___##___#####/ __ \_###_____#######
#/ /#__/ __ `/ __ `__ \/ _ \###/ /#/ / |#/ / _ \######
/ /_/ / /_/ / /#/ /#/ /  __/##/ /_/ /| |/ /  __/######
\____/\__,_/_/#/_/#/_/\___/###\____/#|___/\___/#######
end
###______########################____#################
##/ ____/___#_____#___##___#####/ __ \_###_____##_____
#/ /#__/ __ `/ __ `__ \/ _ \###/ /#/ / |#/ / _ \/ ___/
/ /_/ / /_/ / /#/ /#/ /  __/##/ /_/ /| |/ /  __/ /####
\____/\__,_/_/#/_/#/_/\___/###\____/#|___/\___/_/#####
end
###______########################____#################
##/ ____/___#_____#___##___#####/ __ \_###_____##_____
#/ /#__/ __ `/ __ `__ \/ _ \###/ /#/ / |#/ / _ \/ ___/
/ /_/ / /_/ / /#/ /#/ /  __/##/ /_/ /| |/ /  __/ /####
\____/\__,_/_/#/_/#/_/\___/###\____/#|___/\___/_/#####
end
###______########################____#################
##/ ____/___#_____#___##___#####/ __ \_###_____##_____
#/ /#__/ __ `/ __ `__ \/ _ \###/ /#/ / |#/ / _ \/ ___/
/ /_/ / /_/ / /#/ /#/ /  __/##/ /_/ /| |/ /  __/ /####
\____/\__,_/_/#/_/#/_/\___/###\____/#|___/\___/_/#####
end
###______########################____#################
##/ ____/___#_____#___##___#####/ __ \_###_____##_____
#/ /#__/ __ `/ __ `__ \/ _ \###/ /#/ / |#/ / _ \/ ___/
/ /_/ / /_/ / /#/ /#/ /  __/##/ /_/ /| |/ /  __/ /####
\____/\__,_/_/#/_/#/_/\___/###\____/#|___/\___/_/#####
end
</BODY>
<FOOTER>
version 1
</FOOTER>
